o W-1             	GoToDesktop
o W-2             	GoToDesktop
o W-3             	GoToDesktop
o W-4             	GoToDesktop
o W-5             	GoToDesktop
x C-S-BackSpace   	openbox --reconfigure
o C-A-Right       	DesktopRight
o C-A-Left        	GoToDesktop
o C-A-Up          	GoToDesktop
o C-A-Down        	GoToDesktop
o A-Tab           	NextWindow
o S-A-Left        	SendToDesktopLeft
o S-A-Right       	SendToDesktopRight
o S-A-Up          	SendToDesktopUp
o S-A-Down        	SendToDesktopDown
o A-Escape        	Lower
o A-space         	client-menu
x XF86AudioStop   	playerctl stop
x XF86AudioPlay   	playerctl play-pause
x XF86AudioPrev   	playerctl previous
x XF86AudioNext   	playerctl next
x XF86MonBrightnessUp	xbacklight +10
x XF86MonBrightnessDown	xbacklight -10
x Print           	scrot 'ArchLabs_%Y-%m-%d-%S_$wx$h.png' -e 'mv $f $$(xdg-user-dir PICTURES) ; gpicview $$(xdg-user-dir PICTURES)/$f'
x A-Print         	scrot -d 5 'ArchLabs_%Y-%m-%d-%S_$wx$h.png' -e 'mv $f $$(xdg-user-dir PICTURES) ; gpicview $$(xdg-user-dir PICTURES)/$f'
x A-F1            	rofi-apps
o A-F4            	Close
o A-F5            	Iconify
o A-F6            	ToggleMaximize
o A-F8            	ToggleDecorations
o W-d             	ToggleShowDesktop
o W-b             	ToggleDecorations
x W-f             	exo-open --launch FileManager
x W-t             	exo-open --launch TerminalEmulator
x W-w             	exo-open --launch WebBrowser
x W-e             	geany
x W-m             	audacious
x W-v             	pavucontrol
x W-x             	exit-openbox
x W-Escape        	xkill
o W-Tab           	client-list-combined-menu
x W-s             	skippy-xd --toggle-window-picker
x C-space         	rofi-apps
o W-space         	root-menu
o A-r             	Resize
o A-m             	Move
o S-W-q           	Close
x C-A-m           	xfce4-settings-manager
o W-KP_1          	UnmaximizeFull
o W-KP_2          	UnmaximizeFull
o W-KP_3          	UnmaximizeFull
o W-KP_4          	UnmaximizeFull
o W-KP_5          	MaximizeFull
o W-KP_6          	UnmaximizeFull
o W-KP_7          	UnmaximizeFull
o W-KP_8          	UnmaximizeFull
o W-KP_9          	UnmaximizeFull
o W-Right         	UnmaximizeFull
o W-Left          	UnmaximizeFull
o W-Up            	MaximizeFull
o W-Down          	UnmaximizeFull
o W-A-Left        	UnmaximizeFull
o W-A-Right       	UnmaximizeFull
